...3....X.
.31.......
.13.......
......X...
....2.....
1.....X...
..........
..11....X.
..11.11...
.2.......X
....1..X..