...5......
.....32...
..........
2.........
.13.......
.........4
......2...
......1...
..........
........4.
3...X.....