.......2.....
.....1.......
2.21.........
............3
........4....
......2......
.1.X....1....
....52.....4.
........2....