.5...4...
.........
.......41
..2....5.
.......3.
.......11
..X......
2........
...12....