.3.1......
......1...
..1.111...
..1.......
....1.2..3
1....X..1.
..........
...11.....
......11..
..2..1....