1...........X
.............
.............
.............
.111.1.1.1.2.
..3..121..2..
..1..1.1.2.2.
.............
.213.4.3.212.
.121..2..12..
.212..2..212.
.............
....9...9....