..3......
....1....
.....11..
1..X....1
.....11..
....1....
.2.......