.....1..
3.......
.......5
1...1.X.
..3.....
...2....
.2......