...2.1...
.....2...
........3
1...X...1
..1....1.
....1....