..2..........
..........6..
.............
.........6...
4............
4.......X....
....4........
.............
.......6....5
.............
.............
.......1....5
.............
.....6..4....