..1....X
.....11.
.....11.
1.......
1......1
.111....
.111....
.111....
....1...