.2.2.1.........
..1.2.....1....
............1..
3..........1...
.......211.....
.......121..1..
.......112...1.
...1...........
...1......11...
....1.....11...
..1.........X.1