..........1
..1...3....
1.........X
.1.....1...
11.1111....
.1........1
.1.........
.1.....1..1
.1.........
11.1111....
.1.....1..X
1..........
..1......1.
..........1