1...........X
.............
.1..1..1..1..
..1..1..1..1.
.1..1..1..1..
.............
..2.2...3.2..
.3.3.2.3.1.1.
.2...3.1...3.
..3.2...2.2..
...3.....2...
.............
...6..9..6...