..2.....
.......4
2.....1.
...1....
....X...
4.......
3.......
....1...