..4.......
..........
..........
....1.....
......2...
......4...
2..X......
.........4
..........
.....3....
..........