....2.....
.2........
.1.....1.1
31......1.
..1.......
...X.1....
.....2....