....3...X..1
............
..........3.
.......1....
............
3...........
...1.4...4..
............
....3.......