.....2..
..X.1...
.......2
.......3
........
.12.....
3.......
...23...