....2.......
......1.....
4...........
.........1..
...3........
.........X..
..4.........
...4........
.....6..2...
............
...........3
......2.....
........2...