.........2.
........1..
.......1..1
....111....
.........1.
...22......
1..22......
.......2...
.....1.....
.12........
.21........
X.....1....