........3....
...........1.
..2...22....1
....1....1..1
.........1..1
1.........1..
.1..X..1.....
.1.....3.....
...4.........