.......121.
.2...1.....
....1.....1
.....2.....
....2.....1
...1....X..
..31......1
2..........
......2....
...1....13.
..2........