....5..5...
..........4
...........
211.......2
....1......
.X..1..1..1
....1......
.1........2
2..........
...........
..........4
...3..8..7.