..1..222.....
4............
.............
1..X........3
1............
1....1.1.1.1.
1.....2...2..
1....1.2.1.1.
....2........
.2...1.3.1.1.
......1...2..
...2.1.....2.