....X...
2.......
.......2
.11111..
.1....1.
........