....1...
..11.111
.1.....1
.1.....1
1...X..1
.1......
.1......
.1111...