.2..1....
........5
.........
1...X...1
2.......1
....1..3.
...1...2.