.....2.4....
.........3..
...1......1.
..........4.
2..........3
1...X..2....
.2......114.
..1.........