...1..2..
.2.......
....1....
......1.X
..2......
..1......
123....11
..1..2...
...23....