.........2...
..1..........
....11.11....
....11.11....
....11......1
....11....11.
1.....3...11.
.11..........
.11......X...
...1.........