.2.2.2....
..2.1.....
........1.
3.........
......11..
......11..
...1..11..
......11..
..1.X....2