...3......
..1...2...
..1.......
.3........
.....2.12.
..1...11..
...11.....
..1.....2.
.......1..
1...X....1