....1......
..4.....4..
11.....3...
1.....2....
......1....
....X......
......1..3.
..1.......3
.2.........
3..........
....1......