..1.........
......2....4
.1...1......
..2.1.......
............
.2.....3..3.
........43..
.........4..
X..1..1.....
.....2......