..111.11..
2.........
.....1....
..2..11...
.....1....
.....11...
2......X..
.3........
....1.....
.........1
.2111111..
........1.