..3......
2........
..3....X.
3........
........2
...1...1.
1........
1.....1..
......2..
.122.....
.....3...
....3....
.2..1....