.2...........
...2.........
2.......234..
..1.......1..
.......1.....
..3..........
.....2.11.1..
....2........
.....3.2....1
.1....X.....1
.....1......1
...........2.
......1......